#####################################################################
# #   #                 #   # #   #                     #   #       #
# # # # ### ### ####### # # # # # # ############### ### # # # ##### #
#   # # # #   # #   #     #   # #   # #           #   #   #   #   # #
##### # # ### ### # ######### # ##### # ######### ### ######### ### #
#     #     #     #   #       # #     # #       #   #   #       #   #
# ### ### ######### # # ####### # # ### # ### # ### ### # # # ### # #
# # #   # #       # # # #       # #   # #   # # #   # # # # # #   # #
# # ### # ####### ### # # ########### # ### # ### ### # # # # # #####
# #   # # #     # #   # #         #   #   # # #   #     # # # #     #
# # # # # # ### # # ############# # ##### # # # ####### ### # ##### #
# # #   # #   # # #             # #   #   # #   #     #     # #   # #
# # ##### ##### # ######### # ### ### # ### ##### ### ##### ### # # #
# # #     #     #         # #     #   # #     #   #   #   # #   #   #
# # # ##### ############# # ####### # # ##### # ### ### # # # ##### #
# # # #               #   # #       # # #   #   # #   # #   #   # # #
# # # ############# # # ### ##### ##### # # ##### ### ######### # # #
# # # #   #         # # #         #     # #   #     # #     #   # # #
# # # # # # ### ####### # ######### ### # ### # ### # # ### # ### # #
# # # # # # # # #       # #       # #   # #   # # #   #   #   #   # #
# # # # # # # # # ####### # ##### # ##### # ### # ####### ##### # # #
# # #   # # #   # #   #   #   # # #       # # # #       #   # # # # #
# ####### # # ### # # ####### # # ######### # # ### ### ### # # # # #
#           #   #   #         #             #       #       #   #   #
#####################################################################
