###################################################################
#           #       #           #   #                       #     #
### ##### ### ### # # ######### # # # ############# ##### ### # ###
#   #   # #   # # #   #   #   # # #   #           #   #   #   #   #
# # # # ### ### # ### # # # # # # ##### ######### ### ### # ##### #
# # # #         #   # # # # #   # #   # #       #   #   # #     # #
# ### ############# ### # ####### # # # # ### # ### # # # ##### # #
#   # #   #       # #   # #       # # # #   # # #   # # #     # # #
# # # ### ####### # # ### # ######### # ### # ### ### # ### ### # #
# # #   #     # # #   # # #         # #   # # #   #   # #   #   # #
### ### # ### # # # ### # ######### # ### # # # ####### ##### ### #
#     #   # #   # #     #   #     # # #   # #   #     #       #   #
# ### ##### ### # ######### # # ### # # ### ##### ### # ####### # #
# #       # #   #         # # #     # # #     #   #   #     #   # #
# ####### # # ########### # # ####### # ##### # ### ####### # ### #
# #   # # # # #   #   #   # # #       # #   #   # #   #     #   # #
# # # # # # # # # # # # ### # # # ##### # # ##### ### ######### # #
#   # #     # # #   # # #       # #     # #   #     # #     #   # #
# ### # ##### # ####### # ######### ### # ### # ### # # ### # ### #
# #   # #     # #       # #       # #   # #   # # #   #   #   # # #
# # ### # ##### # ####### # ##### # ##### # ### # ####### ##### # #
# #   # # #   # # #   #   #   # # #       # # # #       #   #   # #
# ### ### # # # # # # ####### # # ######### # # ### ### ### # # # #
#   #       #   #   #         #             #       #       # #   #
###################################################################
