#################################################################
#     #   #         #       #   #                           #   #
### # # # # ##### ### # ##### # # ################# ####### # # #
#   # # # # # #   #   #       #   #   #           #       # # # #
# ### # ### # # ### ################# # ######### ### ### # ### #
# #   # #     #       #             # # #       #   #   # #     #
# ### # # ########### # ##### ##### # # # ### # ### ### # ##### #
#   # # # #       #   #     #     # # # #   # # #   #   # #   # #
# # # # # ####### # ############# # # # ### # ### ### ### # # # #
# # # # # #   # # # #       #     # # #   # # #   #   #   # # # #
### # # # # # # # # # ##### # ##### # ### # # # ####### ### # ###
#   #   # # # # # #   #     #     # # #   # #   #     #   # #   #
# ##### # # # # # ######### # ### # # # ### ##### ### # # # ### #
#   # # #   # # #         # # #   # # # #     #   #   # # # #   #
# # # # ##### # ######### # ### ### # # ##### # ### ### # # # ###
# # #   #   # #     # #   #     #     # #   #   # #   # #   #   #
### # ### # # # ### # # ######### ##### # # ##### ### ######### #
#   #     # # # #     # #         #     # #   #     # #     #   #
# ######### # # ####### # ######### ### # ### # ### # # ### # # #
#   #       # # #       # #       # #   # #   # # #   #   #   # #
# # ######### # # ####### # ##### # ##### # ### # ####### ##### #
# #           # # #   #   #   # # #       # # # #       #   # # #
# ############# # # # ####### # # ######### # # ### ### ### # # #
#               #   #         #             #       #       #   #
#################################################################
